rey: hlt gax hrb
nhb: ttd
yzv: qnv nif iyv
kyu: wdd knt
ehq: jne ued kfq
eaq: jqy sxd
etf: orn emz ewx vrc
cds: eoh rey
vcv: xbj fha
sxd: lzn khc cds yvf fcg fyu rmk npo euq
fwk: krn jqy
pwa: zin jku idt lul itk
azt: out
jzo: dpv svi you
oaz: rak irl wuy
hwq: rss
sns: obd ncx fwl rql
fxm: eqi cok
cuc: qwx yyz sxe
nfl: rvo dxj
eqi: etf vvj bcu ojv asb nzz ehj gaq nkn ubu
brp: ukq ssd
fpc: ukq cjy
wtg: sxd
ags: kyg
zai: ton zdo jyn
nhi: krn jqy
njv: qdg gau fcx rci
zwt: kjb elb dvo
moc: nxj obh yua
uwh: sxe qwx mfo yyz
gsp: sxd
gaq: njt wir
zfa: dpv you svi
gau: enz
asg: nvb ctl
fnd: cdi xqj dac rch
mnc: gpo
iyv: dyb wwr
irl: pmm bls
ebx: wdd ymt knt
giz: dpv
cfn: ddc rax
gks: sus ukh
rql: dje bug nhi vdk
tmq: ipf ilk bvg tpf
rce: dpv you svi
lzn: ffl
wot: emc upt lyj xut
exb: nhq
svr: mcp ess vsn epm
tko: krn
dvu: nvb
aph: cok cyz eqi
awy: wgv lxy qax
znj: out
syi: mwn iip ekk
eii: efh
rga: hvy era
ehp: gsp cge
bxv: vme rax
wpp: wuy wfl rak irl
dxz: svi you
era: cok
tzq: yjw xbj
wfc: rus wyw
rfl: mwn
cii: eqi
grt: hqs jzn dtj
nsm: ghq boa wof
wbu: gvh
ctl: xut upt emc lyj
ckl: fxx knj dyx
kdh: era cii
omo: ldi oaz wpp
cjy: cyz eqi
jww: shi iwp wot nvb
fbq: pmc por liv
xlu: iyi pwa
lbq: oqt xzw
xun: tbw qpb
vsn: fry hwl fmv lbf zfu
iip: enp dat kml nsm exb hea gvx zgf ems xil ift rwu vfs znl oce thb qxu otm
aya: suh
ems: kip yzv
vff: cnv hmc ghw tlo
noc: eqi cyz
you: lpj obx exh qep cuc hwq ntj ekh dpd rqy lia
gum: nmw iyi
bia: ued
vgt: cok eqi
jmp: dlp thb oce ift vfs rwu kmm ems rum xil zgf yfl nsm sub dat kml enp
cyz: etf nxq hfy asb rfk uzf nzz gaq ojv vvj snj wte ehj yog hww
ewf: tbw
goq: noc gat cvh
boa: sdi cbu njv pvl
odt: iip jmp ekk mwn
img: wen vjl
eie: oac ord ttd
pmc: mxx dtx dtn eri
zin: cok
ian: jqy sxd
orn: eaq zra
jne: ekk iip mwn
fwl: bug vdk fwk dje
kgy: fdy
obd: fwk dje bug
epm: zfu zwt hjn jnj djl lbf dtm ewq yvc oiq hwl jjh fry eie
ekk: oqg enp qkf sub dat kml nsm exb yfl hea zgf gvx xil rum ift vfs znl thb oce qxu otm
baa: suh iol egs
ewx: zra
lpl: nzq ctj
xqj: zfa hen jzo
pqk: obh
pul: vsk hao
sme: dct hik wpj
dcp: dvu
fas: yck tbf
mxx: wwr jeu dyb
gfi: msh
nhn: uob rss
hxs: kci zma uhj
fha: tbf xee
lyj: dpv svi
zzj: out
lia: hqs dtj
afp: zmm
lsi: ddh mcv urx
vdk: sxd krn
wwr: uvr hgu zjx iyf pqk odv lsi dfz xlu tcm afp aty tmv aqg bcw cag moc zhe gum ecl xph xhn guc
osa: tkf bmv
wof: njv
vrc: zra tko yde
vvj: vrc ewx
hik: wwr dyb
cge: krn jqy
rrz: svi dpv
zwc: miw
fii: knt
ket: fdy dfn bqt gai
dtn: wwr jeu
krf: xqj
cok: uzf qhk ojv nxq hfy hww
xee: jks cxm din
xwz: lpl snl cjn
isv: gpo
qxu: nbz cxj erd wfc axv
rbs: cvh gzh noc
myk: pko ukh
ilk: fnk
xps: qtv dwe
dlp: sme ovf nhq ajw
yvj: knj sve
tiq: jgq dkk nka
jyo: svi
pwz: isv
hmc: yvj ckl prw qka
cyy: you
cag: xng zmm gqb
gze: lsu
bmc: wwr jeu
jzn: vjl
fnk: cok cyz
fxx: out
nmw: jku idt itk
dwe: wwr
nvb: upt xut
uvr: yua
xil: nhq sme ovf
otm: nhq ajw tjx ovf
ghw: ckl hyy prw
wuy: pmm gzj bls
tnw: isv oki zpz
dtx: dyb jeu
euq: oas lbq gxm
qlt: iip ekk
asb: pua pwz
liv: lwg dtn
byr: xyi bwt djf gdy
mhy: egb osa lsu
knt: cok
snl: ctj jwr nzq uzt
nhq: hik
gat: cyz
nzq: nfl
krn: dcp euq gwl syo npo bzb sec fcg cds khc awy sws fyu cvk yyi jmi qpr
qev: wpp fid oaz mdu
iyf: qyn tyl coz tmq
xng: ymi nlb fpc
yvf: gfi lxy qax tfn
rak: bls gzj pmm
miv: dpv svi you
tbf: din jks
upt: you dpv
xzw: vsk hao
ycq: fha fas xjj
yws: oqt pul czr
zpz: gpo zjo hxs
cjn: jwr ctj
knj: out
cwr: iwb egb osa
tqc: sus
fmv: xun
egs: mwn ekk
oqg: kca wof boa ghq
acb: zsu dhx mas
thg: por
kjb: zwc smo
mwn: xil zgf otm rwu kml qkf dat sub exb yfl ems rum kmm gvx oce dlp thb qxu vfs znl ift enp hea nsm
sve: out
lpj: lpl snl
wur: nuv qev asn
hlt: gdy xyi bwt djf
dac: jzo zfa hen jyo
gvx: yzv yop
rvo: jgq
nvf: svi dpv
bls: mae
fpm: out
obh: wtm lrx
zas: jeu
ukh: wwr dyb jeu
rwu: kca wof boa
hen: dpv you
mcp: nhb fry caw eii jjh oiq yvc ewq cts lbf djl jnj nxp fmv hjn zwt
sus: dyb
tkf: mwn iip jmp ekk
zfu: ttd
nlb: cjy ssd
ukq: cok
wyy: rss kyg uob
yed: byr hrb ltm gax
xjj: xee tbf
gpo: kci uhj roj
vsk: euo rce
dhx: ekk mwn
ata: bqt dfn
fof: gat
emz: zra tko
thb: ajw sme
tmv: xng zmm gqb
scs: vme
djl: bxv wvk scs cfn
scr: nvb wot iwp shi
kca: snv pvl
zgn: giz agy miv
yjw: xee yck
svn: knq emt
bmv: iip jmp
nxj: kdh wwj
ekh: snl cjn lpl
jku: eqi cyz cok
dfm: sns baz dfk
qax: zgn wgn
bgq: hpx nvf sib lmo
bli: vgt
enp: vul xps
smo: bia
tcm: ket bjw ata
odv: wut ddh mcv urx
ift: yzv yop kip
bfe: gxm ckf lbq
nxq: mof gbv
hgu: tyl tmq
sxe: gjj
zjo: cmx uhj kci
rqy: etk cjn lpl
jeu: cag iyf bcw zjx tmv aqg aty guc xhn ecl xph dfz xlu gum afp lsi pqk odv
mkp: tiq
wvk: ddc rax
lbf: cfn scs zos bxv wvk
npo: oas yws gxm
itk: eqi cok
jqy: khc sec fcg cds bfe euq dcp gwl syo npo jmi qpr yyi sws cvk
ipf: fnk
ehj: mof leq zai
ddh: rbs fof
guc: wut ddh urx
srt: aya jgr bqs baa
zos: vme
yfk: smo uzm
jjh: kjb yfk
hpx: dpv svi you
yck: cxm
prw: fxx
xyi: svi
hhl: gks myk tqc oal
qep: jzn img hqs
zma: krn
vxm: oki mnc
yde: jqy sxd krn
ckf: czr pul
kcr: jqy krn sxd
enz: dyb wwr
dfn: yru twh fii
uzm: bia ehq
oac: yht qlc lru
zsu: jmp ekk
amc: iip jmp mwn
cyp: out
baz: kxr ncx fwl rql
gam: out
yua: wwj rga kdh wtm lrx
ghq: cbu sdi snv
hrb: bwt
mcv: rbs goq
meh: cok cyz
qkf: kip yzv
ajw: dct hik wpj
lxy: wgn zgn
xph: obh nxj
pad: yyz qwx sxe
edm: iip jmp mwn
gqb: ymi nlb brp
iwp: upt emc lyj
yog: tnw pwz vxm
nkn: zai leq gbv
gzj: znj mae
iyi: itk lul zin
hao: jeh rrz euo
ssd: cok cyz eqi
cxj: wyw hhl
dje: krn
qka: knj fxx dyx
jyn: sxd
wdd: cyz eqi cok
lul: cyz
lru: gtv edm scf
iol: mwn
kfq: iip
gzh: cok cyz
bcd: odt
pko: dyb wwr
dtm: lay elb dvo kjb
cvk: bgq
ovf: dct
wgv: msh wgn zgn
pra: fas yjw
fif: kup zgt
dfz: ual kgy
lrx: era hvy meh cii
fft: gks myk oal
fcw: bqw
miw: jne kfq
jgr: iol
pmm: gam
eri: wwr
wte: leq mof zai
xwk: egb
xbj: yck xee
oit: mwn ekk jmp iip
seh: ekk iip mwn
dyb: guc ecl xph tmv lsi dfz zjx gum xlu zhe pqk
vme: syi aqj pim
agy: dpv svi you
ovk: iwb egb
sec: fci bgq jvl
sub: fbq thg wbu
qyn: ipf bvg tpf
ltm: xyi gdy
uob: vcv
lsu: uyu
kip: iyv nif
pvl: qdg gau nkk fcx rci
gxm: xzw pul oqt
cxm: out
bty: rrz euo
zra: jqy
zdo: sxd krn
wwj: era hvy fxm meh cii
zgf: axv nbz cxj erd
sws: ffl fnd krf
vfs: wbu jbd
xaw: tbw srt qpb kbs
bvg: vgt aph
vul: dwe bzf bmc
etk: nzq uzt
mof: jyn ton eom
mqv: tlo
jnj: acb bcd
pim: ekk mwn
gai: fii ebx kyu
rsy: tbb fpm zzj
bqt: kyu twh yru fii ebx
cbu: qdg gau nkk fcx rci
tdo: jog
lmo: you dpv
gvh: mxx lwg dtn eri
rmk: wgv gfi qax tfn
pua: isv oki mnc
iwb: bmv uyu
nka: out
qlc: qlt amc edm gtv
dnq: nka
urx: goq fof rbs
fci: sib cyy nvf
jog: cyp tbb zzj
tbw: baa bqs jgr cgx
may: nko vcv
oal: pko sus
nns: tiq dxj dnq
euo: svi you dpv
tfn: zgn
asn: fid
ttd: yht lru
dkh: jzo hen zfa jyo
axv: fft rus wyw
nzz: ozc nhw qdf dfm
oiq: bxv zos scs
ldi: wuy
djf: dpv svi
hwl: ewf xun
nif: jeu dyb wwr
cnv: ckl yvj
uwe: hmc
bwt: svi you
bzb: rey krd eoh
zgt: nbb
snv: nkk rci fcx qdg
ozc: dfk baz
qtv: jeu wwr
ffl: rch dkh dac xqj cdi
mfo: uwe
hqs: fif wen
nxp: ovk gze mhy xwk
wir: lhl bqw
por: mxx dtx dtn
aqj: iip
wyw: tqc myk
erd: hhl fft
vjl: kup tdo zgt
qhk: fcw
lay: smo uzm
dat: yzv kip
qdf: dfk
hea: jbd
hvy: cok eqi cyz
czr: bty vsk
ubu: ewx vrc
ord: lru
yyz: vff mqv gjj
jbd: liv pmc
fdy: fii ebx kyu yru
scf: ekk iip mwn
fid: wfl irl
gjj: ghw cnv
rss: ycq tzq vcv
jve: bmc
njt: svn bqw
emt: kcr
mdu: wfl
khc: yed eoh
dkk: out
yyi: lxy qax tfn wgv
uzf: mof gbv
qdg: ggb zas zte enz
ecl: bjw ata ket
bqs: seh egs iol
yht: amc
kbs: jgr
jgq: out
ddc: oit pim aqj
qnv: jeu
msh: giz agy
aqg: pwa
nbz: rus wyw hhl
fcg: dvu jww scr asg
yru: knt ymt wdd
ymi: ssd
sdi: nkk fcx gau
jeh: dpv
bzf: dyb
jks: out
xut: svi dpv
leq: ian
emc: dpv
egb: uyu bmv tkf
mae: out
wbo: twh yru
lwg: wwr
ntj: dtj img hqs
gtv: jmp
jmi: fci bgq
yop: iyv
eff: jeu
sib: you
bug: krn sxd
mas: jmp iip
dxj: jgq
jwr: nns mkp
kup: rsy nbb jog
cts: ttd ord
zte: jeu wwr
snj: hge vxm pua pwz tnw
ctj: nns mkp nfl
zjx: tyl
tlo: hyy ckl prw qka
gbv: zdo eom jyn ian
zhe: bjw
bqw: aag emt kwq ehp
caw: cwr mhy ovk
kci: jqy krn
ymt: eqi cyz
exh: snl cjn lpl
ewq: xwk cwr mhy gze ovk
bcw: qyn
rfk: njt
oas: pul czr xzw oqt
aty: yua nxj
hyy: sve dyx
kwq: cge fel
arj: eaq zra
hjn: xaw xun ewf
suh: jmp ekk iip
znl: kca boa ghq
wen: kup
ued: iip jmp mwn
cdi: jzo hen jyo
oqt: hao vsk
ess: eii jjh hwl yvc eie nhb fry caw nxp jnj fmv hjn zwt zfu ewq dtm cts lbf djl
fcx: ggb enz
lhl: ehp aag
hfy: qdf
rus: oal myk gks
qpr: asg jww dvu
iok: uob may
dyx: out
dpv: exh iok obx qxp grt pad lia rqy ags wyy ekh ntj nhn hwq xwz
cvh: eqi cyz
fry: ord ttd
uyu: jmp ekk iip mwn
roj: krn
nuv: mdu
rch: zfa
qpb: aya bqs baa
obx: omo
wfl: pmm gzj
uzt: mkp nns
hww: arj emz vrc
kml: wfc axv
iko: odt mas dhx zsu
jvl: lmo nvf
wut: fof
hge: mnc oki zpz
syo: ffl fnd
kmm: xps jve
ojv: qdf ozc
knq: cge wtg
ual: gai wbo bqt fdy
cmx: sxd jqy
cgx: seh
wtm: meh fxm
dpd: hqs jzn img
oki: hxs zjo
dct: wwr dyb
rum: fbq thg
gwl: scr asg jww
qfz: nuv qev asn
dtj: fif
oce: xps
nbb: zzj fpm azt tbb
elb: uzm
rax: rfl oit syi pim aqj
krd: hlt byr ltm
yfl: ghq boa wof
tjx: eff wpj hik
uhj: jqy krn
bjw: bqt
aag: gsp
eoh: hlt gax ltm hrb
bcu: orn emz arj ewx
kyg: ycq pra
nko: fas yjw xjj fha
gax: xyi
tbb: out
nkk: zte enz
zmm: fpc nlb
twh: wdd
dfk: obd kxr
fyu: ffl
tyl: bvg
eom: sxd jqy
kxr: bug nhi vdk
wpj: wwr dyb
ggb: jeu wwr
ncx: vdk dje fwk
qxp: qev asn
ton: sxd krn jqy
shi: lyj emc upt
svi: pad qfz lpj qxp iok qep uwh nhn hwq ntj wyy ags wur lia
nhw: sns dfk
yvc: iko acb
din: out
efh: dhx
fel: jqy krn
gdy: you svi dpv
qwx: uwe vff mqv
idt: cyz cok
xhn: qyn coz tyl
coz: ipf bli
wgn: dxz miv
tpf: fnk
dvo: smo
rci: ggb enz zte
